TwK zjLusxcXmrBb YGsotUmFBbZn PpvwdLWYP | TsZLYXYpBvFbxzrWnU dtmoBGwwPbjKsm PLuc 
lLvmLHNgnjQKOUMlw | ULlwHNnKlMmOgvLjQ
GowZzyON | ZyOoNwGz
QmfBxuUnMGLoWWLYUbPgtENOmiXZRKHy | MGbWftUBEKmLOUPuLQNxyYWnoRHiZmgX
thHp GbJjNVfzGxIJVUPjuIlwDjqL | DGjzxJwIlNjL fjPIhVVbqGpJUtuH
qELbhrkGNZWCkKxqicGYXELSPp | ELZbCqpckXhPWKGrNEqYLxiGSk
Heelo Codevval | Hello Codeeval
psiJoIVLELeclcj | ElJiLepIcjsocVL
dizyKiNAuyeCRZjGmYyCzEQhCA rR | CiZ eKRAryjRzQhNGmCzCYyiyAudE
VHYxhBSoSHsUpLnkC | oHsCBkSULYhxHnVSp
ZwKuE | ZKEwu
XNmjfntkzmwsiveREcYgDfusMCLSg | vsmwecSmiNfDRggCuYzjEMtfkLXsn
Hello Codeeval | Hello Codeeval
hwt FLGPJyl | hJwF lPLGyt
jiqhkraoFTVjrUNila | hViaqraNFrUjiTlkjo
lXGRi lmRcfMjesGZNs | lGZjf RsXGMsieRNcml
aoi UlfiXJkcSehAbgevioWMKpo SnwztJtJ | oehaXkJinJtibcvg pK eiSUAowStfloWMzJ
NMaEC | NaMCE
xBB iKevWzavGhMKSUEMiakkKPoZzkttbo  | koPMKBbKEeoBa kzxUMZkiSvaWKht zGtiv
HYJFBvUFPJlsjIpZzfuBmddKgyTvpNAXCakR | kvsNdApdaTyFJXzRKjYHuIBJBpgUPfmFvlCZ
hELLO cODEEVAL | Hello Codeeval
QnWlBXDpCpClIQMqwSmadFoba | DqmBIQFllappCCSWwMabdnQoX
PrvrGJybpGxUApSbpUWgEVijx | ibVvSygWrUrAUPbxGEpJGjpxp
eLjxoSHmZ qqcnAvbyzGsJqid | vxJbiqqHsLomZecnAGzqSjd y
AUTl hkyE ovhwD gIpqMTCZfCgWV | DyhkMATvgoZp wl fhTCEgVUCW qI
OVoqjeLegtaeu | eoeOqLVegjuat
ZiZTCdguDYNXXqVZJUhfNqwoY | CNYXuDZTYdqNiZfXqVoZhUwgJ
nZEHwkZlvyj EdcNZeRGrQwyOVLCuWs | wjLHnNCkuyyEdZWElZvQwOZRrGeV cs
QYizxU COPwVx | PVxzC OiYUxQw
kgAcidMlTzXMxIvoKJQyWSb mTsQHzmuYfk | QMmzdvYgXlMiHTkmIkusTJASWbcxQyK zfo
ITPuCiZFansVQiKpnkbPC | isknuFnaCipbZVKIQCPTP
pMWeWHPqncgnbxbCvUjjVFmhtmbaUxSs | jgWUjeCFbxpsbthbcnaHVUmvMPmnWqxS
vEBbKkyql | BylkbqEKv
EDijXFQHtIEhBT | HDiTXFEItQEjhB
fZwKHjhofgmlHEqIbcukj aSMgzyQHS | MQgzSjygKmowaIjHhHf lHkubEcSqZf
UixTPh | iPhTUx
pTQBTnWwwVAKXwYPcuH | XTwnuBcVWPwYKQTpAHw
iWBWMyFLKm PixGrIbkYWWiuqhepwU gFq | MmuGrgpkiKWFFyYWUbehLIwq iBWq WPix
enQdFuPfxyz | ynxdePQFzuf
OYYyRQSlPEPODMpLPUebzfvztklh | PQetMhRDSEPYfUzPzllkybYOpvLO
